S...oo.............oo.o.......
.....o..........oo..o..oo....o
...oo.............o..oo.......
........o.....o..o...o........
.....o.........o.o......o.....
o...o.............oo...o.oo.o.
oo..o........o..o...oo....o.o.
.......o..............o....o..
..o...o..............o.o...o..
.o..o.oo..o..o....o...o.......
.o....oo.....o...o..o......o.o
.oo.....o...............oo..o.
...o..............o.....o.o...
...o..o...o......o........o..o
...o............o...o..o......
...........oo...oo.o..........
..o.................o...o.....
..o...........o....o..oo.o....
......o.............o.....o...
......o.............oooo..o..o
..oo..........o..o.......oo...
.o........o.......o...........
o.o.o.oo....o.o..........o....
oo........o..o.oo..o......o...
...o......o....o...o..........
.o.....o....o.ooo.oo....oo..o.
.....o......o....o.o..o.o..o..
...oo..o...o...o..oo........o.
.o.o...........o..............
......o..o..o.........o......E