S......o..o....o.o.oo.....oo.........o.....o..........o.....oo....o...........o...o.......o..o......
.............o.....o.o...oo.......oo.....o.....oo...oooo.......o.....o..............o..o.......o...o
...ooo..............o...o...o.........o....ooo.oo...o.o.........oo.o.oo....o.o............o.....o..o
........o..o..........o.....oo..o..o....oo....o....o....oo......o.....oo.....o..................o.o.
.....o..o.......o....o...........................oo..oo....o.oo...o.o...o..........o....o.......o.o.
....o..o...o..o......o.oo........o...........................................o.....oo..o....o.....o.
....o..o...o.....o........o.o....o....o.o...........o..oo.......oo...o...o..oo......o....o..o....o..
........o...oo...o...........o.o..........o...o..........o..o.oo.....................o..........oo..
..o....................o.....oo.............o..........o.oo................o......o....o.o..........
....o.o.....o..o.......oooo.........o...o.......oo..oo...o...oo..o...o....oo....o.oo..o....o.o..oo..
..o........oo........o.o...................o..oo........oo..o....o.o.oo.o....o....o......o.....o....
...o...o...o.......o...o.....o..oo...o........................o....oo.....o.o.......ooo....o....o...
..........ooo...oo...oo.o.......o........o....o...........o..oo...oo....o.o............o.........o..
....o.........................o...o............o.o...o......o...oo..ooo...o..o.o..o.o..o.........o..
o...o.....o........o.......o............................o........oo..o.o......o....o.ooo......o...o.
......o.o....o....o......o........o..........o..o..o..o..o.oo...o.......o.oo.o.....o..oo.......o....
.o..o.o..o.o...o.o.o.o.....o.......oo.o..o......o...oo...o.o.........o..o.......o..................o
..........o.......ooo.....ooo.....oo.o..o...........o.o............o...........o.o....o.o....oo..o..
..o..o.............o..o.o....o..o....o..o.o..o.o...o...o.........o..........ooo........o..o..oo....o
............o.....oo.......ooo.o..............o...o...o..o...ooo.o...o..oo.....o..........o......oo.
..oo.........o.....o.o.......o..o.....o.o......o..oo.o.....o...................o..oo...oo...o..oo...
.......ooo...o......o..........o.o.o....o..o..........o..oo.............o..o........o....o..........
..o........o.o.........o.o...........o.......o..o......o....o...............oo...o............o.....
...o...............oo.........o......o........o.oo..o.........................o.o..o.........o..o.o.
..o..o....o...oo.o.........................o..o....................oo..o............o.......o...o...
....................o..o............o......oo....oo.....o.o..o...o.......o....oo..o..o.......o......
..o...o....o.o...o.o.ooo..............o......o..o......oo....o.....................o..o..o....o...o.
.o....o..................o..o..........o.oo.oo........o.....oo..o...........o.o......o.o....o.......
...o.o...o...........o.....o.oo........o..o..o..o..........oo........o.......o.o.....o....oo...o....
...o..o...oo.o.o.....o.o.o.......o......o......o......o.o.o..o..o.o.o.....o.......o.................
.o.o....oo.......o....o.........o.....o..o............o...ooo............o..o...o......oo.oo........
...o......................o......o..ooo....o..o...oo.o...oo..o...o....o........................o....
.....o.......o.o.o.....o...o............o...o..........o...o.....oo.....o..........o..o....o....oo..
..o........oo.................o......o.......o.......oo.o..o...............o....o....o..o.........o.
.......................o.oo..o..o.........o.o.........oo....o........o..o..........ooo......o.....o.
..o........oo.........o........o...oo.o....o.oo.o..o.o.o..............o........oo.....o.....o.o....o
....ooo.o..o.ooo.oo.........o...ooo..o.......o....o...o.oo......o..oo...o.o.oo.....o................
....oo........oo.......o.......o...o...........o.....................oo.......o...o..o..o....o......
..................oo..o.......o....o....oo.o....o...........o.o.o...o....o....o...o.o...............
..oo..o.....o.o......o.....o.o.......o...o...o...o...o.o.................o........o.....o...........
.o...o.o...o.............o...o...............oo......oo.........o..........oo.o....o....oo......o...
.o..............o.......o.o..oo..........................o.....oo...............o...............o...
.......ooo.......o....o.......o........o.....o....oo...............o.o.....o.....o..........o.......
.o..o.o..............o..o.ooo............oo......o.........o...o.....o............o..o.....o........
.o....o....o..................o...o......o.........o.....o..........................o..o.o.o.o......
...o.....o.oo....o.......ooo.o.o.......ooo...o...o.o.............oo..o.o..o...............oo...o....
.o....o.o.o..o..oo.oo.oo....oo..............o.o..o....o.....o.......o..o......o..o..........o.......
.o...oo.........o.................o...oo..o......oo.........o.o....o.o........oo....oo...o.....o....
..o...................o...o....o..o...............oo.o...o...o...........o....o.o.......o..o.....o..
..oo....o.....o...o.........o.o.....ooo.............o...........o.......o.o...o..o.o.......o.......o
..o......o....o..ooooo.....o.....oo.....o.....oo........o.........o....o....o............o.oo......o
o....o.........o.o.o...oo...o.o...o.......o.o...o................o..oo....o......o.oo........o.o....
o.......o......o..........o..o...oo..oo.......o.o.o.........o...o.o......o..............ooo..o.o.o..
..................o.o...o........o............o.oo..o..ooo...o.........o...............o..o.o.......
....o......o....o.......o............o..o..........o..o....o..o..o....oo....o...o....o.o...o........
o...o......o.o..o.....o......o..o....oo.o....o......ooo...........o............o.....o.o........oo.o
..............o..o.ooo.oo....o.o....o.o..ooooo..o...........o.......o.o.......o.o.....o...o....oo...
.......o.....o.o.....o....o.o........o...o....o..................o...o.....o....ooo..........o....o.
...o.o.o.....o..o.o...o..o........o..................ooo....o.....o.o.o..o....o.o.o.....o.o.........
o...oo..oo..o...o.......o.o..o.........o..........oo............o.....oo.o.oo.o..oo......oo.o.......
oo....o..o.......o.....o......o..o.....o...........oo.....oo.....o.....o..o..o..o........oo.oo.o.oo.
....oo......oo..oo..o...oo..oo................o.o....o.....o......o.o.............o.o..............o
..o.o........oo.o.......oo.o.o..........o..........oo.o.........oo..o.....o..............o...oo.o..o
o...o...o...o....o.....o...o.......o....o..o.....oooo.............o................o...o..o.....o...
..o.o.....o.......o....o.........o...o.o....oo.....o..oo.............o.o...........o....oo.....o.o..
...oo..o....o..................o..o.....o..ooo.o.........o.ooo..o........o..........o.o..o........oo
.....o..........o..o.o....................o.......o..o...o..o.oo.o.o.o...ooo...o........o..o.......o
.o.o......oo.........oo.o..o..oo.o...o..........o....oo.oo..o..oo.......o....o.o..o...o.............
.o......o.oo...o............o..o.........o.........o.....oo....o......o....o....oo..o..o..o.......o.
........oo....o......o....o.oo....oo.o..oo........oo.o..o......o...........o.......o..........o.....
o.....ooooo.........o.o.....o.o..........oo...o.....ooo..o...........o.o....o...o....oo...o.o.......
..........o..o...........oo.o...o.........o........................o.....o.......o........oo........
.....o.....oo..o.o....o...o...o...........o.o...............o.o.o.........ooo...ooo......o..........
o............o......o.....o.o................o......oo............o.o.............oo..o.....o......o
o........oo....oo..o..............oo.....o...........o.....o..o...............o..................o..
.o...oo.......o..........ooo...o..o................o.o......oo.o..........o..........o......o.oo....
.o...........ooo..o....ooo..oo..........o.o..ooo..........o...o.......oo.o.o..........oo............
.....o.o..o......o..o...o.o...o.ooo.oooo...............o....o.oo.o.o.........oooo..o....o.......o...
oo...o.oo....oo..o........o.o.......o...o..o........o...o......o.....o...............o.o....o.o..o.o
..ooo........o.o......o....o..oo.o...o..o.o..o.o......o..o.o.o..oo............o.....o..o..ooo.......
.oo.....o.......ooo...o..o........................o..o....o.....................o....o......o....oo.
...oo.o..o.......o.....o.o......oo..o.......o.o.o...o..........o.o.oo..........o.......o.o...o......
.....o...o....o....oo...o...........o...o....o..oo...........o.....oo.o.o.oo...oo...o...............
...oo......o.o..o..oo...o.........oo.o.........oo.o.o...o......o...oo...o..o..............o.........
....oo...o....oo....oo.....oo..o.............o.......o.o.o........oo...o...o......o......o....o.....
.....o.......o....o.o.o..oo..o.....o....o.....o.............................o..ooo...o....o.....o...
...........o.o...........o......o.o.o.......o.o....o.........o............o......o...o..oo..o.oo...o
...o.......o......................o...o...o.o..o...o...........oo..o.o....o............o.oo.........
oo....o.o.........o.o.o...................o.o...........o..................o..o...o.o........o....o.
...........o............oo.....o..o..o...ooo.o....o.........o.o.o..oo.........o.o.oo....o........o..
.o..oo.......o.o..o......oo.....o..........oo........o..o...............o...........o..........o....
..o.....o..........o..o.o....o.....o...............o............o............o........o........o....
.o..o.....o..............o.oo.....o.o...oo.........o..o.....o.......o..oo..o.......oo..o.o..o....o..
...o....o.oo....o.o.o..........o...o..oo...o.....o.....oo.o..o.....oo....ooo..ooo............o.o....
.......o.o.........o....o.o......o.o.o.......o...o.....o....o.ooo..oo.o.o...................o..o..o.
.o..o..........o.......o..oo........oo......o.......o......oo...oo.....o.o................o...o.oo..
...ooo.o..........o.................o.........o.......oo....o............o.oo...oo.............o....
oo.oo...o....o..o.........o.....o......oo....o.........o....o.o...o.....o...o........o....o....o....
......o......oo...o..............o......o............ooo........o....o....o.....o...........o...o.oo
...oo....o.o................ooo....ooo....o.....o.o......o....ooo..oo.......o......o.o..o..o.......E